1111111111111111111111111111111111
1000000000000000000000000000000001
100000000M00000000000000M000000001
1000000011110000000000111100000001
10000M00111100C0000C00111100M00001
1000M000111100000000001111000M0001
10000000111100M0000M00111100000001
100000000000M00000000M000000000001
100C000000000000B0000000000000C001
1000000000000000000000000000000001
1000000011110000000000111100000001
10000M0011110000000000111100M00001
1000M000111100000000001111000M0001
1000000011110000000000111100000001
1000000000000000000000000000000001
1000000000000000000000000000000001