1111111111111111111111111111111111
1000000000000000000000000000000001
100000000000000000000000M000000001
1000000011110000000000111100000001
1000000011110000000000111100000001
1000000011110000000000111100000001
1000000011110000000000111100000001
1000000000000000000000000000000001
1000000000000000B00000000000000001
1000000000000000000000000000000001
1000000011110000000000111100000001
1000000011110000000000111100000001
1000000011110000000000111100000001
1000000011110000000000111100000001
1000000000000000000000000000000001
1000000000000000000000000000000001
1000000000000000000000000000000001