1111111111111111111111111111111111
1000000000000000000000000000000001
1000000000000000000000000000000001
1000000011110000000000111100000001
1000000011110000000000111100000001
1000000011110000000000111100000001
1000000011110000000000111100000001
1000000000000000000000000000000001
10000000000MMMMMMMMMM0000000000001
1000000000000000000000000000000001
1000000011110000000000111100000001
10000000111100000N0000111100000001
1000000011110000000000111100000001
1000000011110000000000111100000001
1000000000000000000000000000000001
1000000000000000000000000000000001
1111111111111111111111111111111111