1111111111111111111111111111111111
1000000000000000000000000000000001
1000000000000000000000000000000001
1000000000000000000000000000000001
1000000001100000000000011000000001
1000000001100000000000011000000001
1000000000000000000000000000000001
10000000000000000B0000000000000001
1000000000000000000000000000000001
1000000000000000000000000000000001
1000000000000000000000000000000001
1000000001100000000000011000000001
1000000001100000000000011000000001
1000000000000000000000000000000001
1000000000000000000000000000000001
10000000000000000N0000000000000001
1111111111111111111111111111111111