11111111111111111
10S10000000100001
10011000000D00001
1000D000000111111
11111000000011111
1000D0000000D0001
11111000000011111
10000000000000001
10000000000000001
11111111111111111