11111111111111111111111111111
10000000001100000000000011111
10110000011100000000000011111
10010000000000000000000011111
11111111101100000111000000001
10000000001100000111011111011
11110111111111011100000010001
11110111111111011101010010M01
11000000110101011100000010001
10000000000000001100000010001
10000000000000001101010010001
11000001110101011111011110N01
11110111011101010101111010001
11111111011111110111111111111