1111111111111111111111111111111111
1000000000000000B00000000000000001
1000000000000000000000000000000001
1000000011110000000000111100000001
1000000011110000000000111100000001
1000000011110000000000111100000001
1000000011110000000000111100000001
1000000000000000000000000000000001
1000000000000000000000000000000001
1000000000000000000000000000000001
1000000011110000000000111100000001
1000000011110000000000111100000001
1000000011110000000000111100000001
1000000011110000000000111100000001
1000000000000000000000000000000001
1000000000000000000000000000000001
1000000000000000000000000000000001
1111111111111111D11111111111111111
1111111000000000011111111111111111
1111111011111111111111111111111111
1111111011111111111111111111111111
10D00M00001100000000M00M1111111111
101100000111000C000000M01111111111
100100M00011000000M000000111111111
1111111110110000011100000000111111
1000M0000011M000C111D11111D1111111
1111D111111111D1110000001000111111
11110111111111011101010010M0111111
11000C0011010101110M00M01000111111
1000000000M000001100000010N0111111
10000M00000000001101C1001000111111
1100000111C10101111101111000111111
1111M11101110101010111101000111111
1111111111111111111111111111111111