11111111111111111111111111111
10000M00001100000000M00M11111
101100000111000C000000M011111
100100M00000000000M0000011111
11111111101100000111000000001
1000M0000011M000C111011111011
11110111111111011100000010M01
11110111111111011101010010001
11000C0011010101110M00M010001
1000000000M000001100000010N01
10000M00000000001101C10010001
1100000111C101011111011110001
1111M111011101010101111010001
11111111011111110111111111111