NO ./assets/north_texture.xpm
SO ./assets/south_texture.xpm
WE ./assets/west_texture.xpm
EA ./assets/east_texture.xpm

F 220,100,0
C 225,30,0

1111111111111111111111111111111111
1000000000000000000000000000000001
1000000000000000000000000000000001
1000000011110000000000111100000001
1000000011110000000000111100000001
1000000011110000000000111100000001
1000000011110000000000111100000001
1000000000000000000000000000000001
1000000000000000B00000000000000001
1000000000000000000000000000000001
1000000011110000000000111100000001
1000000011110000000000111100000001
1000000011110000000000111100000001
1000000011110000000000111100000001
1000000000000000000000000000000001
1000000000000000000000000000000001
1111111011111111111111111111111111
1111111011111111111111111111111111
1111111011111111111111111111111111
1111111011111111111111111111111111
1111111011111111111111111111111111
10000M00001100000000M00M1111111111
101100000111000C000000M01111111111
100100M00011000000M000000111111111
1111111110110000011100000000111111
1000M0000011M000C111D11111D1111111
11110111111111D11100000010M0111111
1111011111111101110101001000111111
11000C0011010101110M00M01000111111
1000000000M000001100000010N0111111
10000M00000000001101C1001000111111
1100000111C10101111101111000111111
1111M111011101010101111010C0111111
1111111101111111011111111111111111