111111
100101
101W01
110001
111111