NO ./assets/wall1.xpm
SO ./assets/wall2.xpm
WE ./assets/wall3.xpm
EA ./assets/wall4.xpm

F 76,44,23
C 225,116,145

1111111111111111111111111111111111
1000000000000000000000000000000001
1000000000000000000000000000000001
1000000011110000000000111100000001
1000000011110000000000111100000001
1000000011110000000000111100000001
1000000011110000000000111100000001
1000000000000000000000000000000001
1000000000000000000000000000000001
1000000000000000000000000000000001
1000000011110000000000111100000001
1000000011110000000000111100000001
1000000011110000000000111100000001
10000N0011110000000000111100000001
1000000000000000000000000000000001
1000000000000000000000000000000001
1000000000000000000000000000000001
1111111111111111111111111111111111