NO ./assets/wall1.xpm
SO ./assets/wall2.xpm
WE ./assets/wall3.xpm
EA ./assets/wall4.xpm

F 76,44,23
C 225,116,145

11111111111111111
10000001010000001
10000001010000001
10000001D10000001
11111000000011111
1000D000N000D0001
11111000000011111
10000001D10000001
10000001010000001
10000001110000001
10000000000000001
10000000000000001
10000000000000001
10000000000000001
11111111111111111