NO ./assets/wall1.xpm
SO ./assets/wall2.xpm
WE ./assets/wall3.xpm
EA ./assets/wall4.xpm

F 76,44,23
C 225,116,145

1111111111111111111111111111111111
1000000000000000000000000000000001
1000000000000000000000000000000001
1000000011110000000000111100000001
1000000011110000000000111100000001
1000000011110000000000111100000001
1000000011110000000000111100000001
1000000000000000000000000000000001
1000000000000000000000000000000001
1000000000000000000000000000000001
1000000011110000000000111100000001
1000000011110000000000111100000001
1000000011110000000000111100000001
1000000011110000000000111100000001
1000000000000000000000000000000001
1000000000000000000000000000000001
1000000000000000000000000000000001
1111111111111111011111111111111111
1111111111111111011111111111111111
1111111111111111011111111111111111
1111111000000000011111111111111111
1111111011111111111111111111111111
1111111011111111111111111111111111
1000000000110000000000001111111111
1011000001110000000000001111111111
1001000000110000000000000111111111
1111111110110000011100000000111111
1000000000110000011101111101111111
1111011111111101110000001000111111
1111011111111101110101001000111111
1100000011010101110000001000111111
10000000000000001100000010S0111111
1000000000000000110101001000111111
1100000111010101111101111000111111
1111011101110101010111101000111111
1111111111111111111111111111111111