NO ./textures_xpm/naturalbricks_hd_verydark.xpm
SO ./textures_xpm/naturalbricks_hd_verydark.xpm
EA ./textures_xpm/naturalbricks_hd_verydark.xpm
WE ./textures_xpm/naturalbricks_hd_verydark.xpm


C 0,0,0
F 0,0,0


111111
111111
11N111
11 111
