
NO ./textures_xpm/naturalbricks_hd_verydark.xpm
SO ./textures_xpm/naturalbricks_hd_verydark.xpm
EA ./textures_xpm/naturalbricks_hd_verydark.xpm
WE ./textures_xpm/naturalbricks_hd_verydark.xpm


C 155,100,160
F 111,111,111

        1
11111111N11111111
10000000000000001
10100000100000101
10000000000000001
10001000100010001
10000000000000001
10101010001110101
10000000111000001
100010001 1100001
10000000111000001
10100000100001001
10000000000000001
11111111111111111
